border_size=1
usage=map

Ww          , Ww          , Ww          , Ds          , Ds          , Gs          , Gs^Ft       , Gs^Ft       , Gs^Ft       , Gs^Ft       , Rd          , Rd          , Re          , Re          , Re          , Re          , Gs          , Gs          , Ds          , Ds          , Ds          , Gs          , Gs          , Hh          , Gs          , Hh          , Hh          , Gg          , Gs^Fms      , Gs^Fp       , Gs^Fp       , Ss          , Ss          , Ss          , Ss          , Ss          , Sm          , Ss          , Ss          , Ss          
Ww          , Ww          , Ds          , Ds          , Gs          , Gs          , Gs^Ft       , Gs^Ft       , Gs^Ft       , Gs^Ft       , Re          , Re          , Re          , Re          , Gs          , Gs          , Gs          , Gs          , Gs          , Ds          , Ds          , Gs          , Gs          , Gs          , Gs          , Hh          , Hh          , Gs^Fp       , Gs^Fms      , Gs^Fp       , Gs^Fms      , Gs^Fp       , Ss          , Ss          , Ss          , Ss          , Ss          , Ss          , Ss          , Ss          
Ww          , Ww          , Ds          , Gs          , Chr         , Gs^Ft       , Rd          , Rd          , Re          , Re          , Gs          , Gs          , Gs          , Gs          , Gs          , Gs          , Ds          , Gs          , Gs          , Gs          , Ds          , Gs          , Gg          , Gg          , Gs          , Hh          , Hh          , Hh          , Hh          , Gs^Fms      , Gs^Fp       , Gs^Fp       , Ss          , Ss          , Ss          , Ss          , Ss          , Ss          , Ss          , Ss          
Ds          , Ds          , Gs          , Chr         , 1 Khr       , Chr         , Re          , Re          , Gs^Vht      , Re          , Re          , Gs^Ft       , Gs^Ft       , Gs^Ft       , Gs          , Ds          , Ds          , Gg          , Gg          , Gs          , Gs          , Gg          , Gg          , Gg          , Hh          , Hh          , Hh          , Mm          , Mm          , Hh          , Gs^Fp       , Ss          , Ss          , Ss          , Ss          , Ss          , Ss          , Ss          , Sm          , Ss          
Ds          , Ds          , Gs^Ft       , Chr         , Chr         , Chr         , Re          , Gs          , Gs          , Gs          , Gs^Ft       , Re          , Re          , Gg          , Gg          , Gs          , Ds          , Ds          , Gg          , Gs          , Gs          , Gg          , Gg          , Gg          , Hh          , Hh          , Mm          , Hh^Vhh      , Mm          , Mm          , Mm          , Ss          , Gs^Fp       , Ss^Vhs      , Ss          , Ss          , Ss          , Ss          , Ss          , Ss          
Ds          , Gs^Ft       , Gs^Ft       , Chr         , Chr         , Chr         , Re          , Gs^Vht      , Gs          , Gs          , Gs^Ft       , Gs^Ft       , Gs          , Re          , Re          , Gg          , Gs          , Ds          , Gg          , Ds          , Ds          , Gg          , Gg          , Hh          , Mm          , Mm          , Mm          , Mm          , Mm          , Mm          , Mm          , Ss          , Ss          , Gs^Fp       , Ss          , Ss          , Ss          , Ss          , Ss          , Ss          
Ds          , Gs^Ft       , Gs          , Gs          , Gs          , Gs          , Re          , Gs          , Gs          , Gs^Ft       , Gs^Ft       , Gs          , Gs          , Ds          , Re          , Gg          , Gg          , Gs          , Gg          , Ds          , Gg          , Gg          , Gg          , Hh          , Ww          , Ww          , Ww          , Ww          , Mm          , Mm          , Mm          , Mm          , Hh          , Gs^Fp       , Ss          , Ss          , Ss          , Ss          , Ss          , Sm          
Gs          , Gs^Ft       , Gs^Vht      , Gs          , Re          , Re          , Gs          , Gs          , Gs^Ft       , Gs          , Gs          , Gs          , Ds          , Ds          , Re          , Gg          , Re          , Gg          , Gg          , Gg          , Gg          , Gg          , Gg          , Ww          , Ww          , Ww          , Ww^Bw/r     , Ww^Bw/r     , Mm          , Mm          , Mm          , Mm          , Mm          , Hh          , Gg          , Ss          , Ss          , Ss          , Ss          , Ss          
Gs          , Gs          , Re          , Re          , Re          , Re          , Gs          , Gs^Ft       , Gs^Ft       , Ds          , Gs          , Gs          , Ds          , Gs          , Ds          , Re          , Ds          , Re          , Re          , Re          , Re          , Gg          , Re          , Ww          , Ww^Bw/r     , Ww^Bw/r     , Ww          , Ww          , Mm          , Mm          , Mm          , Mm          , Hh          , Hh          , Gg          , Ss          , Ss          , Ss          , Ss          , Ss          
Re          , Re          , Re          , Re          , Gs          , Rr          , Gs          , Gs          , Gs          , Gs          , Gs          , Gs          , Gs          , Gs          , Gs          , Gs          , Gs          , Gs          , Gs          , Gs          , Gs          , Re          , Re          , Ww^Bw/r     , Ww          , Ww          , Hh          , Hh          , Hh          , Hh^Vhh      , Gs^Fp       , Hh          , Gg          , Gg          , Gg          , Ss          , Ss          , Ss          , Ss          , Ss          
Re          , Re          , Gs^Ft       , Gs^Ft       , Gs          , Gs          , Gs          , Gs^Ft       , Gs          , Gs          , Gs          , Ds          , Gs          , Gs          , Gs^Vht      , Ds          , Gs          , Ds          , Ds          , Ds          , Gs          , Gs          , Gg^Vh       , Re          , Re          , Ww          , Hh          , Hh          , Gg          , Gg          , Gs^Fp       , Gs^Fms      , Gg          , Gg          , Gg          , Gs^Fms      , Gs^Fms      , Ss          , Gg          , Ss          
Re          , Re          , Gs^Ft       , Gs^Vht      , Gs          , Gs          , Gs          , Gs          , Gs          , Gs          , Gs          , Ds          , Gs          , Ds          , Gs          , Gs          , Gs          , Ds          , Ds          , Ds          , Ds          , Ds          , Gs          , Gg          , Hh          , Ww^Bw\r     , Re          , Gs^Fp       , Gs^Fp       , Gg          , Gg          , Gg          , Re          , Re          , Re          , Gs^Fp       , Re          , Gs^Fp       , Gg          , Gg          
Gs^Ft       , Gs^Ft       , Gs^Ft       , Gs          , Ss          , Gs^Ft       , Gs          , Gs          , Gs          , Ss          , Gg          , Gs          , Gs          , Gs          , Gs          , Gs          , Gs          , Ds          , Ds          , Ds          , Ds          , Gs          , Gs          , Gg          , Ww          , Ww          , Gg^Vh       , Re          , Re          , Re          , Re          , Re          , Gg^Vh       , Gg          , Gg          , Re          , Gg          , Re          , Re          , Re          
Ds          , Ds          , Gs^Ft       , Ss          , Gs^Ft       , Gs^Ft       , Gg          , Gg          , Gg          , Ss          , Ss          , Gg          , Gg          , Gs^Ft       , Gs^Ft       , Gs          , Gs          , Ds          , Ds          , Ds          , Ds          , Gs          , Gs          , Gg          , Gg          , Ww          , Ss          , Gg          , Gg          , Gg          , Gg          , Gg          , Gg          , Gg          , Gg          , Gs^Fp       , Gs^Fp       , Gg          , Gg          , Gg          
Ss          , Ds          , Ss          , Ss          , Gs^Ft       , Ss          , Ww^Bw|r     , Ds          , Ds          , Ss          , Ss          , Ds          , Ds          , Gs^Ft       , Ds          , Gs^Ft       , Gs          , Gs          , Gs          , Gs          , Gs          , Gs          , Gg          , Gg          , Gg          , Ww          , Ss          , Gg          , Gs^Fms      , Gs^Fp       , Gg          , Gg          , Gg          , Gg          , Gg          , Gs^Fp       , Gg          , Gs          , Gs^Fp       , Hh          
Ww          , Ss          , Ss          , Ds          , Ds          , Ds          , Ww^Bw|r     , Ww          , Ss          , Ss          , Ss          , Ds          , Ss          , Ds          , Ds          , Gs^Ft       , Gs^Ft       , Gs          , Gs          , Gs          , Gs          , Ds          , Gg          , Gg          , Gg          , Ss          , Ss          , Gg          , Gs^Fp       , Gs^Fms      , Gg          , Gg          , Gg          , Gg          , Hh          , Gg          , Gs          , Hh          , Gs^Fms      , Hh          
Ww          , Ww          , Ww          , Ww          , Ww          , Ww          , Ww^Bw|r     , Ww          , Ss          , Ss          , Ss          , Ss          , Ds          , Ds          , Gg          , Gs^Ft       , Ds          , Gs          , Gs          , Gs^Ft       , Gs^Ft       , Gg          , Gg          , Gg          , Gg          , Ss          , Ss          , Gg          , Gg          , Gg          , Gg          , Gg          , Gs          , Gs          , Gs^Fms      , Gs^Fms      , Hh          , Gs^Fms      , Gs^Fms      , Hh          
Ss          , Ww          , Ss          , Ww          , Ww          , Ww          , Ww^Bw|r     , Ww          , Ww          , Ds          , Ds          , Ss          , Ds          , Ds          , Gg          , Gg^Vh       , Ds          , Ds          , Gs          , Gs^Ft       , Gs^Ft       , Gg          , Gs^Fp       , Gs^Fp       , Gs^Fp       , Ss          , Gg          , Gg          , Gg          , Gg          , Gg          , Gg^Vh       , Hh          , Gs^Fp       , Hh          , Gs^Fms      , Gs^Fds      , Gs^Fms      , Gs^Fp       , Gs          
Ss          , Ss          , Gs^Ft       , Ds          , Ss          , Ww          , Ww^Bw|r     , Ww          , Ww          , Ww          , Ww          , Ds          , Gs^Ft       , Ss          , Ss          , Ss          , Gs^Ft       , Ds          , Gg          , Gg          , Gg          , Gg          , Gs^Fp       , Gs^Fms      , Gs          , Ss          , Ss          , Ss          , Gg          , Gg          , Gs^Fds      , Hh          , Hh^Fp       , Hh          , Gs          , Hh^Fp       , Gs^Fds      , Gs^Fms      , Gs          , Gs          
Ss          , Gs^Ft       , Ds          , Ds          , Ss          , Ss          , Ss^Vhs      , Ss          , Ss          , Ww          , Ww          , Ds          , Gs^Ft       , Ss          , Gs^Ft       , Gg          , Gg          , Gs^Ft       , Gg          , Gg          , Gg          , Gg          , Gs^Fms      , Gs^Fms      , Gs^Fp       , Ss          , Gs^Fp       , Ss          , Gg          , Gs^Fds      , Hh          , Hh          , Gs^Fms      , Hh          , Gs          , Hh^Fp       , Hh          , Gs^Fms      , Hh          , Hh          
Ds          , Ds          , Ds          , Ss          , Ss          , Ss          , Chs         , 2 Khs       , Ss          , Ww          , Ww          , Ww          , Ww          , Ss          , Gs^Ft       , Gs^Ft       , Gg          , Gg          , Gg          , Gg          , Gs^Fp       , Gs^Fp       , Gs^Fms      , Gs^Fms      , Gs^Fp       , Ss          , Ss          , Ss          , Ss          , Gs^Fms      , Hh^Fp       , Gs^Fms      , Gs^Fms      , Gs          , Hh          , Hh          , Hh^Fp       , Hh^Fp       , Gs^Fms      , Gs^Fp       
Gs^Ft       , Gs^Ft       , Ds          , Ss          , Ss          , Ss          , Ss          , Chs         , Ss          , Ds          , Ds          , Ww          , Ww          , Gs^Ft       , Gs^Ft       , Gs^Ft       , Gs^Ft       , Gg          , Gg          , Gg          , Gs^Fp       , Gs^Fms      , Gs^Fms      , Gs^Fp       , Ss          , Ss          , Gs^Fp       , Ss          , Hh          , Hh          , Gs^Fms      , Hh          , Gs          , Hh^Fp       , Hh^Fp       , Gs          , Gs^Fp       , Gs^Fms      , Gs^Fms      , Gs^Fms      
Ds          , Gs^Ft       , Gs^Ft       , Ds          , Ds          , Ss          , Ss          , Ss          , Ss          , Ss          , Ss          , Ww          , Ww          , Ww          , Ss          , Ss          , Gs^Ft       , Gs^Ft       , Gs^Fp       , Gs^Fp       , Gs^Fp       , Gs^Fp       , Ss          , Ss          , Ss          , Ss          , Gg          , Gs          , Hh          , Gs^Fp       , Gs^Fp       , Gs^Fp       , Hh^Fp       , Hh^Fp       , Gs          , Gs          , Gs^Fp       , Gs^Fms      , Gs^Fp       , Gs^Fp       
